10
10
H H H H H H H H H H
H 1 N N N N N N N H
H N N N N N N N N H
H N N H H N N N N H
H N N N N N N N N H
H N N N N N N N N H
H N N N N N N N N H
H N N N N N N N N H
H H H H H H H H H H