10
10
HHHHHHHHHH
H1NNNNNNNH
HNHNNNNNNH
HNNNNNNNNH
HNNNNNNNNH
HNNNNNNNNH
HNNNNNNNNH
HNNNNNNNNH
HNNNNNNNNH
HHHHHHHHHH